
xx xx xx xx xx
 xx xx xx xx
  xx xx xx
   xx xx
    xx
---
 x x x x x x x
x x x x x x x
 x x x x x x x
x x x x x x x
